NO ./path_to_the_north_texture
SO ../path_to_the_south_texture
F 0,0,0
WE ./path_to_the_west_texture
EA ./path_to_the_east_texture
C 0,0,255

1111111111111111
1000000000000001
100000W000000001
1000000000000001
1111111111111111
1111111111111111
1000000000000001
1000000000000001
1000000000000001
1111111111111111