F 22,20,0
SO ./path_to_the_south_texture
NO ./path_to_the_north_texture
EA ./path_to_the_east_texture
WE ./path_to_the_west_texture
C 23,24,24


1111111111111111111111111
100000000110000000000001
1011000001110000000000001
1001000000000000000000001111111111111111111111111111111111111111
111111111011000011100000000000000000000000000000000000000000001
1000000000110000111011111111111111111111111111111111111111111111
11110111111111011100000010001
111101111111011101010010001
11000000110101011100000010001
10000001100N000100000010001
1000000000000111010010001111
11000001110101011111101111000111
11110111 1110101 101111010001
11111111 1111111 111111111111