NO ./path_to_the_north_texture
SO ./path_to_the_south_texture
WE ./path_to_the_west_texture
C 225,30,0

EA ./path_to_the_east_texture
F 220,100,0



        1111111111111111111111111111111
        1000000000000000000000000000011111111111111111111111111111111111
        1011111110000000000000000000000000000000000000000000000000000001
        1011000000000000000000001111111111111111111111111111111111111111
        1011000000000000000000001
        1011000000000000000000001
        1011000000000000000000001111
        11111100000000000000000000111111
             111111000000000W00 0000000011111111111111111111111111111111111
                10000000000000000000000000000000000000000000000000000001
                10000000000000000000011111111111111111111111111111111111
                1111111111111111111111


